P P P P S P P P P.
P E P P P P P P P.
P S P P P P P P P.
P S P P P P P S P.
P S P P P P E P P.
P P P P P P P P P.
P S P P P S E P P.
P S P P P P P P P.
P S P E P S P H P.
P P P P P P P P P.
