P P P P S P S P S P,
P E P S P P S P P P,
P S P P P P S P P P,
P P P P P P P S S P,
S P S P S P P P P P,
S S S S S P P P P P,
E E E P E P P H P P,
P P P P P P P P P S,
P S P P P P P S P E,
P P P P E P P P P P,
