P P P P P P P P P P,
P S E S P P P P P P,
P P S S P S P P P P,
P P S P S P P P P P,
P P S E P P P P P P,
P P P P P H P P P P,
P P P P P P P P S P,
P P S S S P P P P P,
P S P E S P P P P P,
P P P S P P P P P P,