E P P P P P P S P P,
P S P P P S E P P P,
P P P P P S S P P P,
P P P P P P P P P P,
P P H S P P P P E P,
S P P S P P S P P P,
S P P P P P P P P P,
P P P P P P S P P P,
P P P S S S P P P P,
P P P P P P P P S P,