P P P P P P P P P P,
P P S P P P P P P P,
P E P S P S P S P P,
P P P P H P S P P P,
P E S P P P P S P P,
P S P P P P P P P P,
P S P P P P P S S P,
P P P P P P P P E P,
P P S P P P S P S P,
P S P E S P S S P P,
